   2  3  1  2  3  2  2
2 [5, 3, 7, 6, 1, 4, 2] 4
4 [3, 1, 5, 4, 6, 2, 7] 1
3 [1, 6, 3, 2, 4, 7, 5] 2
2 [2, 7, 4, 3, 5, 1, 6] 2
3 [4, 2, 6, 5, 7, 3, 1] 3
1 [7, 5, 2, 1, 3, 6, 4] 3
2 [6, 4, 1, 7, 2, 5, 3] 3
   2  3  4  1  3  3  4
